0000000000000000000000000000
0000000000000000000000000000
0000000000000000000000000000
1111111111111111111111111111
1222222222222222222222222221
1211111110111111110111111121
1210000000000000000000000121
1210111110111111110111110121
1210122222222222222222210121
1210121110111111110111210121
1210121000000000000001210121
1210121011101111011101210121
1210121012222222222101210121
1210121012110110112101210121
1210121012110110112101210121
1210121012110110112101210121
1200020012110110112000200021
1210121012110110112101210121
1210121012110110112101210121
1210121012110110112101210121
1210121012110110112101210121
1210121012222222222101210121
1210121011101111011101210121
1210121000000000000001210121
1210121110111111110111210121
1210122222222222222222210121
1210111110111111110111110121
1210000000000000000000000121
1211111110111111110111111121
1222222222222222222222222221
1111111111111111111111111111
0000000000000000000000000000
0000000000000000000000000000
