0000000000000000000000000000	
0000000000000000000000000000 
0000000000000000000000000000
1111111111111111111111111111
1200000000022222000000000021
1011111111111211111111111101
1000000000000000000000000001
1011111112111111112111111101
1022222222222222222222222201
1011111111111121111111111101
1022222222222222222222222201
1011111112111111112111111101
1022222222222222222222222201
1011111111111211111111111101
1022222222222222222222222201
1011111112111111112111111101
1022222222222222222222222201
1011111111111121111111111101
1022222222222222222222222201
1011111112111111112111111101
1022222222222222222222222201
1011111111111211111111111101
1022222222222222222222222201
1011111111111211111111111101
1022222222222222222222222201
1011111111111121111111111101
1000000000000000000000000001
1011111112111111112111111101
1200000000222222220000000021
1111111111111111111111111111
1111111111111111111111111111
0000000000000000000000000000
0000000000000000000000000000
